Adventure	Ambitious	Assemble
Absurdity	Appliance	Advocate
Attention	Allegiant	Absorbent
Anecdotal	Abundance	Amplifier
Ascendant	Assertion	Adjective
Abhorrent	Accolades	Armadillo
Alleviate	Apprehend	Accustomed
Anatomist	Announcer	Affection
Abolition	Aromatic	Aspiration
Allegedly	Adaptation	Attraction
Antiquity	Aberration	Abandoned
Appalling	Audacious	Artillery
Antipathy	Advocate	Arrogance
Apologetic	Abandonment	Absurdity
Beautiful	Butterfly	Breakfast
Blackbird	Blueprint	Bracelet
Birthday	Bountiful	Ballistic
Breathe	Blockade	Bushcraft
Bedspread	Broadcast	Behavior
Befuddled	Belonging	Beneficial
Bewildered	Breathtaking	Belligerent
Bureaucrat	Blatantly	Broadcast
Backyard	Bordering	Breakneck
Benefactor	Beatitude	Boomerang
Biomedical	Backbone	Breakable
Barometer	Bombastic	Blindfold
Beguiling	Bounteous	Bottomless
Colorful	Category	Campaign
Concrete	Category	Chemical
Clamorous	Courteous	Composer
Confident	Consoling	Captivate
Cultivate	Copiously	Craftsmen
Cautiously	Courageous	Cloudberry
Conclusive	Corrective	Composure
Commotion	Closeness	Curiosity
Coalition	Criterion	Cutthroat
Collaborate	Cognizant	Celestial
Celebrate	Cordially	Catastrophe
Credulous	Commendable	Compassion
Confection	Conclusive	Conferment
Confluence	Cacophony	Capturing
Daughter	Delicious	Decipher
Duration	Domestic	Decision
Database	Designer	Diplomatic
Dangerous	Deceptive	Detergent
Declarative	Delineate	Discomfort
Disparate	Dispatch	Different
Deliberate	Discourse	Dedication
Deficiency	Deviation	Divergent
Dexterity	Disclosure	Dramatist
Debilitate	Dissemble	Diabolical
Dissection	Discerning	Dinosaur
Divulging	Disavowal	Distract
Delineate	Derivative	Discipleship
9 Letter Words Starting with E
Elephant	Education	Essential
Eternal	Exchange	Estimate
Energetic	Entrance	Engineer
Effective	Everywhere	Elevating
Elevenses	Eloquent	Empirical
Encompass	Enormous	Evaporate
Eulogize	Evolution	Excitable
Excursion	Executive	Effulgent
Elaborate	Emanation	Elevation
Empowerment	Enrapture	Endearing
Entangled	Envisaged	Epiphany
Equitable	Eradicate	Ephemeral
Equestrian	Esoteric	Estimable
9 Letter Words Starting with F
Fantastic	Formation	Frequency
Furniture	Fingerprint	Forgotten
Fragrance	Financial
Friendly	Formation
Frenzied	Floating
Forever	Friction
Flounder	Frontier	Frustrate
Fertility	Fashioned	Fulfilling
Formative	Forefront	Forgiving
Fulminate	Flavorful	Facetious
Filigreed	Fanciness	Facsimile
Fulcrum	Foretell	Feminine
Factually	Feasible	Foresight
Foothold	Foremost	Footprint
Take free test
9 Letter Words Starting with G
Gardenia	Gradient	Gallery
Generate	Gigabyte	Gleaming
Gleeful	Glorious
Guidance	Gallery
Grandeur	Graphite
Guardian
Glimpse	Grouping
Gorgeous
Galactic	Gallivant	Glistening
Glistening	Greenery	Grudgingly
Gradually	Gladiator	Guardedly
Grappling	Gratitude	Guacamole
Grounding	Gratitude	Growthful
Grandiose	Guttural	Gallantry
9 Letter Words Starting with H
Harmonic	Hospital	Happiness
Heritage	Headache	Humidity
Hilarious	Highway	Handsome
Hardware	Hospital	Homeless
Highlight	Hologram	Horrific
Hundredth	Hydraulic	Hypnosis
Hesitate	Hangover	Harmonic
Harmonize	Halfway	Helpless
Horticult	Humanize	Heartfelt
Heavenly	Hometown	Hydrating
Happening	Halcyon	Honorable
Habitat	Hermitage	Hothouse
Handicap	Haunting	Highbrow
9 Letter Words Starting with I
Influence	Incident	Infinite
Identify	Indicate	Invention
Instruct	Increase	Intrigue
Integrity	Inscribe	Internet
Inquirer	Inscribe	Interact
Insomnia	Informed	Inclusive
Instruct	Inherit	Immerse
Invention	Infinite	Integrate
Inclement	Inversion	Inclining
Incident	Interval	Illuminate
Isolating	Imbroglio	Ineffable
Idealism	Illusive	Impulsive
Insurgent	Instigate	Ignition
Insipid	Illusion	Inactive
Take free test
9 Letter Words Starting with J
Jellyfish	Judgment	Jovially
Jealousy	Journey	Junction
Juxtapose	Joyously	Jamboree
Jubilate	Judicial	Jolliness
Journal	Juvenile	Jittery
Joviality	Journey	Javelin
Jeopardy	Judgment	Jigsaw
Jocundity	Javelina	Jubilant
Juridical	Journeymen	Jigsawed
Joylessly	Justified	Jouncing
Jacaranda	Jazziness	Jiggling
Jam-packed	Jobholder	Jounciest
Jointless	Jumbling	Joineries
Judicious	Jacklight	Juxtaposed
Juxtaposes	Jugulated	Journalist
9 Letter Words Starting with K:
Knowledge	Keyboard	Kaleidoscope
Keepsake	Keyword	Kneecap
Kickstart	Kingfish	Kilogram
Kinetic	Kowtow	Kerosene
Knapsack	Knitting	Keystone
Kinfolks	Kneecap	Knightly
Knickers	Knitwear	Kingdom
Knowledge	Keypunch	Kidnapper
Kinematic	Kneading	Kilocycle
Kombucha	Knavishly	Kielbasa
Kneehole	Kinetin	Katakana
Killdeer	Katabatic	Keyboarder
Keynoter	Keycards	Knockdown
Kibbutzim	Kebabbish	Karyotype
Kilojoule	Kibitzing	Kindlings
9 Letter Words Starting with L:
Landscape	Lavender	Language
Lifelong	Liberty	Lollipop
Learning	Lifetime	Lighting
Loyalty	Laughter	Limited
Lustrous	Lavatory	Liberty
Licorice	Learning	Lifeline
Language	Legacy	Launched
Ludicrous	Luminous	Lingerie
Liftoff	Literary	Laudable
Laminate	Labyrinth	Lavishly
Leapfrog	Lucidity	Linchpin
Lubricate	Luxuriant	Legality
Lavender	Lionheart	Lovebird
Limestone	Landmark	Longevity
Take free test
9 Letter Words Starting with M:
Momentum	Mystical	Material
Midnight	Marathon	Magnetic
Meditate	Meticulous	Mysterious
Minimize	Monopoly	Medicine
Momentum	Musical	Multiple
Modifier	Monogram	Majority
Maritime	Monotony	Mandolin
Meltdown	Maverick	Mutilate
Magnetic	Marathon	Monastic
Manuscript	Memorize	Maternity
Melodramo	Material	Modulate
Marauding	Mankind	Mainstay
Minimized	Multiply	Mendicant
Myriad	Metropolis	Mezzanine
9 Letter Words Starting with N:
National	Necklace	Negative
Neighbors	Notorious	Notebook
Navigate	Nuisance	Numerous
Narrative	Newcomer	Necklace
Nursery	Neglect	Nocturne
Novelist	Newlywed	Nametag
Nominate	Nonsense	Notation
Nautical	Notation	Nectarine
Numbness	Notching	Numerate
Novalike	Nearness	Notarial
Nattiest	Narrower	Nitrogen
Nudeness	Nurturer	Natation
Nonbeing	Nutrient	Naphthalin
Novitiate	Negligent	Nonsexual
9 Letter Words Starting with O:
Operation	Outreach	Overcome
Overlook	Overhaul	Obscurely
Overtake	Obscuring	Offensive
Optimism	Outreach	Obsession
Overpower	Omitted	Outspoken
Overcome	Overpower	Observer
Offensive	Objective	Overdrive
Obstacle	Outnumber	Operator
Obsession	Outsource	Outweighs
Overrated	Outflank	Overtures
Overboard	Overstock	Outbreaks
Occurring	Overlying	Obsession
Overrated	Outshines	Overcloud
Obedience	Ostracize	Obnoxious
Objection	Overgrown	Occasions
Take free test
9 Letter Words Starting with P:
Portfolio	Paramount	Political
Ponderous	Paralyzed	Palpitate
Persuade	Pessimist	Profound
Pleasant	Permeable	Potential
Powerful	Paramount	Peninsula
Pervasive	Patronize	Pedigree
Practical	Plausible	Paragon
Pulsating	Pondering	Political
Pinnacle	Polygraph	Pauperism
Phenomena	Preferable	Provision
Palatable	Propagate	Pulsating
Paralyzed	Palisades	Potential
Pathology	Peculiar	Penetrate
Precision	Pinnacles	Perpetual
9 Letter Words Starting with Q:
Quotation	Question	Qualified
Quicksand	Quandary	Quotidian
Querulous	Quibbling	Quadrille
Quantity	Qualified	Quizzical
Quotient	Question	Quibbling
Quandary	Quizzical	Quarters
Quotidian	Quadruple	Quickest
Quizzing	Quotable	Quandary
Quadratic	Quickest	Quasimodo
Quotient	Quivering	Quadrille
Question	Quizzical	Quotable
Quotient	Quandary	Quacking
Quaintly	Qualified	Quelling
Quasimodo	Quirkiest	Quotidian
Quagmire	Quixotry	Quantity
9 Letter Words Starting with R:
Radiant	Recover	Rejoicing
Remember	Rigorous	Resilient
Restless	Refresh	Reversal
Resolute	Ravishing	Recurring
Readable	Reclusive	Radiance
Reaction	Recover	Rekindle
Relevant	Reservoir	Resistant
Rhapsody	Restrain	Residual
Reunion	Rainbow	Renounce
Resilient	Recreate	Relevance
Readjust	Retrieve	Reclusive
Revitalize	Reflected	Rehearse
Rendered	Receding	Rendezvous
Take free test
9 Letter Words Starting with S:
Sunshine	Symphony	Security
Singular	Stunning	Selection
Strategy	Swirling	Suspense
Scenario	Stunning	Seductive
Scientist	Spirited	Solutions
Snapshot	Smoothly	Silence
Spectrum	Stupendous	Selection
Substance	Sanctuary	Struggle
Spherical	Savoring	Surpassing
Sensitive	Surrogate	Sympathy
Sorrowful	Serenity	Suppliant
Scenarios	Skeptical	Squander
Speculate	Surprising	Stability
Strident	Supremely	Simulated
9 Letter Words Starting with T:
Template	Truncate	Triangle
Tolerant	Traction	Terminal
Tangible	Trifecta	Together
Thriving	Tangency	Truncate
Tolerate	Tradition	Triathlon
Teaching	Tailwind	Tactical
Textbook	Tranquil	Treasure
Triumph	Tolerable	Temporary
Toppling	Treasured	Tenacious
Trimming	Trapping	Tolerate
Tangible	Tangency	Threshold
Truncate	Triumvir	Trillion
Tailwind	Tectonic	Threshold
Tolerant	Truncate	Triangle
Tangible	Trifecta	Together
9 Letter Words Starting with U:
Ultimate	Underdog	Unravel
Underline	Upcoming	Unbiased
Underwear	Upgraded	Undermine
Underpass	Utilize	Underfoot
Unraveling	Unfolding	Upturning
Unleashed	Uploading	Undergone
Unhinging	Unifying	Unheeding
Unearthed	Undergone	Uprooting
Unplanned	Upstanding	Unfurling
Unplugged	Unyielding	Unwilling
Unruffled	Unleashes	Unpacking
Upstream	Unsettled	Unvisited
Unbridled	Unearthing	Uplifting
Uncover	Unmanned	Upsetting
Unplanned	Underling	Upstaged
Take free test
9 Letter Words Starting with V:
Victory	Variable	Vigilant
Violator	Variance	Vibrancy
Vivacity	Vacation	Valuable
Virtuoso	Visitor	Vagabond
Variety	Viewpoint	Vindicate
Validate	Vanquish	Valuable
Virulent	Volatile	Veracious
Vibrator	Vagabond	Volcanic
Venerate	Vernacular	Vagabond
Ventures	Vernacular	Veterinary
Vehement	Visualize	Vivarium
Validity	Veneration	Volcanic
Vigorous	Vigilant	Venturesome
Visionary	Verified	Vanishing
Vanquish	Vexation	Vocalize
Wildlife	Winsome	Wholesome
Wonderful	Workshop	Worldwide
Wondrous	Weltering	Withdrawn
Windshield	Waterfall	Wriggling
Wheeling	Whisperer	Whitening
Wavelength	Wondering	Wrestling
Wandering	Wieldable	Wrathful
Withstand	Windiness	Worldwide
Warranted	Wholesome	Witnessed
Wounding	Winemaker	Wrinkling
Wandering	Worldwide	Watermelon
Wholesome	Wickedly	Whistling
Wonderful	Weariness	Withdraws
Watchful	Whistling	Warehouse
Worksheet	Windstorm	Wrathless
9 Letter Words Starting with X:
Xenophobe	Xerophyte	Xylolysis
Xeroxable	Xylograph	Xenophile
Xanthan	Xanthein	Xylocarp
Xyster	Xanthic	Xiphoid
Xerantic	Xenon	Xerosis
Xerophyte	Xeroxable	Xylograph
Xenogeny	Xanadu	Xylograph
Xenotime	Xeroxing	Xyloside
Xenophobe	Xystus	Xysti
Xenophile	Xanthous	Xylidine
Xylograph	Xylidine	Xenogeneic
Xanadu	Xenogeny	Xanthate
Xeroxing	Xysters	Xenurine
Xyloside	Xysti	Xenogenesis
Xanthate	Xanthans	Xeroxed
Xanthein	Xyster	Xeroxes
Take free test
9 Letter Words Starting with Y:
Yearning	Youthful	Yielding
Yesterday	Yearbook	Yearning
Youthful	Yellowing	Yielding
Yellowness	Yearning	Yearlong
Yellowish	Yearning	Yearbook
Youthful	Yuletide	Yellowish
Yellowing	Yearlong	Yieldable
Yellowness	Yearbook	Yearling
Yellowish	Yielding	Yachtman
Yearling	Yielding	Yearbook
Yellowing	Yearning	Yellowish
Yieldable	Yellowing	Yuletide
Youthful	Yearning	Yielding
Yellowness	Yearlong	Yearbook
Yellowing	Yellowish	Yieldable
Yuletide	Yellowness	Yearning
9 Letter Words Starting with Z:
Zestfully	Ziggurat	Zingiber
Zeppelin	Zucchini	Zeroth
Zamboni	Zealotry	Zirconium
Ziggurat	Zephyranth	Zoologist
Zeroth	Zebrawood	Zymogenic
Zestfully	Zenithal	Zincotype
Zodiacal	Ziggurat	Zirconia
Zippered	Zeppelin	Zoophile
Zwitterion	Zealously	Zeroth
Zebrawood	Zestfully	Zephyr
Zilch	Zitherist	Zoologic
Zircon	Zippable	Zoophobe
Zestfully	Zeppelin	Zirconia
Zymogenic	Zestful	Zebrawood
Zucchini	Zirconia	Zygosity
Zanyish	Zestful	Zibeline